R 1000 1000

NO ./img/greystone.png
SO ./img/colorstone.png
WE ./img/bluestone.png
EA ./img/purplestone.png

S ./img/barrel.png

F 192,192,192

C 128,128,128
      1 1 1 1 1 1 1 1 1 1 1 1 1 1 1 1 1 1 1 1 1 1 1 1 1 1 1
      1 0 0 0 0 0 0 1 1 0 0 0 0 0 0 0 0 0 0 0 0 1 0 0 0 0 1
  1 1 1 0 0 0 0 0 1 1 1 0 0 0 0 0 0 2 0 0 0 0 0 0 0 0 0 1 1
1 1 0 1 0 0 0 0 0 0 0 0 0 0 0 0 0 0 0 0 0 0 0 0 1 1 1 1 1
1 0 1 1 0 0 0 0 0 1 1 1 0 0 0 0 0 0 0 0 0 0 0 0 1       1
1 0 0 0 0 0 0 0 0 0 1 1 0 0 0 0 0 1 1 1 0 1 1 1 1 1 1 1 1
1 1 1 1 0 1 1 1 1 1 1 1 1 1 0 1 1 1 0 0 0 0 0 0 1 0 0 0 1
  1 1 1 0 1 1 1 1 1 1 1 1 1 0 1 1 1 0 1 0 1 0 0 1 0 0 0 1
1 1 0 0 0 0 0 0 1 1 0 1 0 1 0 1 1 1 0 0 0 0 0 0 1 0 0 0 1
1 0 0 0 2 0 0 0 0 0 0 0 0 0 0 0 1 1 0 0 0 0 2 0 1 0 0 0 1
1 0 0 0 0 1 1 1 0 0 0 0 0 0 0 0 1 1 0 1 0 1 0 0 1 0 0 0 1 1 1
1 1 0 0 0 1   1 1 1 1 0 1 0 1 0 1 1 1 1 1 1 0 0 1 1 1 0 N 0 1 1 1
1 1 1 1 0 1   1 1 1 1 1 0 1 0 1 1 0 1 1   1 1 0 0 0 0 0 1 1 1
    1 1 1 1   1 1 1 1 1 1 1 1 1 1 1 1 1   1 1 1 1 1 1 1 1
