R 10000 1000

NO ./img/greystone.png
SO ./img/colorstone.png
WE ./img/bluestone.png
EA ./img/purplestone.png

S ./img/barrel.png

F 192,192,192

C 128,128,128

        111111111111111111
    1111100000000002000001111111
1111100000000000000000000000001111111
111111111000000200000000000000001111111
1111111111110000000020000000011111111111   1111111111111111 11111111111 
11111111111111100000000001111111111111111 111111100000000011110000000011
1111111110000011111111100111111111111111     11111111111000000011111111
11111111000000011111110000011111111111             11111100000111111
1111110200000000111100200000011111111111111111111111111110000001
11110000000200000111100000000000000000000000000000000000001111111
11111002000000011111110000111111111111111111111111111111111
111111110000111111111110011111111111111
1111111110111111111111110111111111111111
1111111000000000000000000000000000111111
111111000000000000020000002000000111111
111100002000000000000000000002000000111111
11100000000000000000000000N00000000001111
110000000000000020000000000000000000011111
1111111111111111111111111111111111111111111
